;Breaker Level File: Level 1
%,%,%,%,%,%,%,%,%,%,%,%
%,%,%,%,%,%,%,%,%,%,%,%
_,_,_,_,_,_,_,_,_,_,_,_
^,^,^,^,#,#,#,#,^,^,^,^
^,^,^,^,^,^,^,^,^,^,^,^
^,^,^,^,_,_,_,_,^,^,^,^
