; Breaker Level File: Level 4
;
; Legend:
;
; Space         _
; Single        ^
; Double        %
; Triple        $
; Unbreakable   #
;
^,^,^,^,^,^,^,^,^,^,^,^
_,_,#,_,_,_,_,_,_,#,_,_
_,_,#,_,_,_,_,_,_,#,_,_
_,_,#,_,_,_,_,_,_,#,_,_
_,_,#,^,^,^,^,^,^,#,_,_
_,_,#,^,^,%,%,^,^,#,_,_
_,_,#,^,%,$,$,%,^,#,_,_
_,_,#,%,$,$,$,$,%,#,_,_
_,_,#,#,#,#,#,#,#,#,_,_
